NO ./wall1.xpm
SO ./wall2.xpm
WE ./wall3.xpm
EA ./wall4.xpm
F 255,0,0
C 0,0,255





   
  
     
111111111111111111111111111111111
11111111100000001111
111111111001111101111111111111111
111111111001111101111111111111111
111111111001111101111111111111111
111111111000000011111111111111111
111111111001111111111111111111111
111111111001111111111111111111111
1111111110011111
111111111001111111111111111111111
111111111001111111111111111111111
      111001111111111111111111111
1111111110011111111111111111N1111
111111111111111111111111111111111